
                                      #          #                    #                              
                             #        #         # #    #                             #               
                                               #        # #                                          
                              #                  #  #   #  #        #                                
                #                    #    #      #  #      #                  #                      
#                                         #      #   #  #                      #                     
                                              #             #       #                                
        #                                        ##    #  #    #                                     
       #                                                                                     #       
                                                ##        #                                          
                                      #            #    #                                            
  #           #                       #                #    ##                                       
                                                                          #                          
                                      ##             #   #                         #                 
                 #             #               #    #  #   # #      # #                              
                                            #    #    #  #   #      # #                #             
                            #                            #                                           
                                      #            #     #                                           
                                      #            # #   ##       #       #  #                      #
                                #     #                                                              
                                             #    #     #   #         # #     #                      
          #        #                                 # #                                             
                                                #                   #                                
                                                       #  #                 #                        
                                                # #  ##     #                     #                  
   #   #                              #        #                    #                                
                                      #                      #                                       
                                                   #  ##                                   #         
                                             # #  ## #   #                                           
                                    # #        #      #       #     #                                
                                                     ##                                              
                                   #             # #     ###       #                                 
                                                        #                                    #       
     #                                           ##      ##         #                                
                         #                            ##                                             
                    #                              #         #                                       
  #         #                           #         # ###            #                                 
    #                                                                                                
           #                          #      #   ##                                                # 
                                                         #          #     #                          
                                                     ## #                                         #  
                                                #                   #                             #  
                                                    #         #                                      
                                      #               #     #         #                              
                                                  ##                 #                               
                                                   #       #                                         
                                      #                     #                                        
                                      #           #  #  #                                            
                     #                        # #   ###        #    #                                
                            #                  #      #  #        # #                                
 #                                    #                                                              
             #                        #                # #          #                                
##                                              #                   #                    #          #
 #                                    #               #  #          #                                
                                          #       #                                #                 
                                      #         #                #                                   
                                                 # #      ##                                         
                                                ### #                                                
#                              #      #              #  #                          #                 
                                           #     #  #      #        #       #                        
                                      #                                                 #            
                                      #     #       # #             #                                
                   #                  #      #      #                                                
                                               #   # ##                    #                         
                                                     #  #   #                                        
    ##                     #        #      #       ## # # ##    #            #                       
                        #    #        #    #          #          #    # #                            
                                                    #                             #  #               
                                                     #                       #                       
     #                                #                #      #                                     #
          #        #                                # #             #                                
                                      #       #          #          #   #                       #    
                               #      #         #      #       #    #                                
                                                          #         #                                
                                                                                             #       
                                      #       #   #   ##     #      #                                
                                   #                #       #                                        
                     #                   #   #    #                                                  
                                      #        ##      #        #   #               #                
                                                    ##                                #        #     
                 #                             #    # #   #         #                     #          
                                              ## #                  #    #                           
                                                 #  #   #  #     #                                   
             #                        #       #   #  # ##                                            
                       #                #         #                                                  
             #                                #    ## #                                              
                                            #          # #                               #           
#                         #           #          #  ###   #         #                                
                                                      #   #                                          
                                      #       ##  ###  #  ##                                         
                                      #    #        #   #   ##      #                  #             
                                                   # #        #                                 #    
                                    #    #      #    #     #        #                                
                                               ##  #  #     #                     #                  
                                                   #                                    #            
                                                                                                     
                      #       #            #        #               #                                
                                       #         #  #    #                #                          
                                      #     #    ###    #  #                                         
                                      #         #     #                                              
                                             #  #       #      #        #                            
   #                                              #   # # #         #   #                  #         
                         #         #                ##              #                                