
                                             #    #        #        ##                               
                                      #                  #                                 #         
                                      #   #     #        # #       #    # #                          
                                                 #    #  #   # #    #                                
                                      #             #   #                   #                        
                                                #   #                                 #              
                                                   #                                                 
                               #                   # #  #     #     #                                
                          #             #      #   ##    #  #                                        
                                      #  #       #     #            #                                
                                      #        #      #  #                                           
                                              #         ##                                           
 #                                                                 #              #                  
     #                                #           #  #                             #                 
                                              ###   ##     #            #                            
                                             #                      #                                
                                                #  #                                                 
                                                      #  #  #                                        
                                             # #                                             #       
                                                     #        #               #              #       
                                                # ##                                 #               
                              #     # #          #                                       #      #    
       #                 #                 #           #                                             
                                                       #  #               ##                         
                 #    #                              #                                              #
                                                   # #    ##        #                                
           #                       #  #          #    #    #                                         
                                      #   #                 #                                        
                                      #          #                                                   
   #                       #          #       #     #   #   #       #                                
                                                 #  #  #       #                                     
                                      #     ##      #               #               #                
                                                #  #                                      #          
                                           #    #    #    #     #                                    
                             #        #     # #                                   #                  
                                               # # ##     #                          #              #
                                                #    # ####         #                                
             #                     #           #  #    #                                             
                            #         #               #      #               #                       
            #                                      ##               #                                
                                                                  # #                                
  #                 #                           #   #  #            #                                
                                                        #       #                                    
                   #         #                  #   # #   #         #                                
                                                                      #                              
                                              #      ##             # #                              
#                                                #   ##             # #                              
             #                        #    #        ###                                           #  
                     #              # #       #  ##                 #                                
                                               #   #    #             #                              
                                      #                 # #  #                           #      #    
                                                    #                                                
                                                                    #                                
    #                                                                                                
                     #                #          #    #                                              
          #                                            #       #    #                                
                                      #           #   # ##                  #      #   #             
                                                 #  #   #  #     #  #     #                #         
                                      #                  #                                           
                               #                  ##  #   #                                          
                                                    #               #                              # 
                                                                                                     
   #                                           #       # #       #    #                              
                       #              #        #    #  #                                             
                                      #              #              #                   #            
        #                                      #     # #                #                         #  
                #                                                              #                     
                                                                                        #            
                                                      #####  #                                       
       #                           #                  #    #          #                              
                                                     #                                               
                                      #           #  #        #                                      
                                                #    ##     #                      #                 
                                             #       #     #                                         
                                      ##           #  #    #        #   ##                           
                                      #                   #               #                          
                        #                  #   #  #   #             #                               #
                                        #               #         #               #                  
 #                                    #           ##       # #                #                      
                                      #         ### #        # #             #                       
                                                 #     #  ##        #                  #             
#                                     #            #        #       #                                
#                                              #   #      # #       #                                
                                                  #    #         #                                   
              #                #              # # # ##                                               
     #                                                        #                                      
  #                                   #          # #    #   #                                        
                                       #             #   #                   #               #       
                                                 #          #                                        
 #                       #          #            #     #                #                            
                                                  # ## #                                       #     
                                                       ###                                           
             #                              #      #  #                                              
                              #      #      #     # #                                                
                                      #              ###                                             
                                         # #           # #          #                                
                 # #                         #   #  #                                                
          #                           #               #   #  #                                       
#                           #         #           ##  #     #                                        
                                                ## #   ##  ##                                        
                                                #   # #                                              
    #                           #         #                                                          
                   #                             # ###    #                                          