
                                                  #                 #                                
                                            #          #                                          #  
                                   #  # #     #    #   #       #    #                                
                                                  # #                                                
                                              #    #    #                                            
    #                                       #  # #         #                                         
                                                     #                                               
                                      #          # #                # #                              
                                                        #           #                               #
                                                                 #        #                  #       
                      #                       #        #            #                                
                                      #            #  #      #        #                              
                                                     #                                               
                                                 #                                                   
                                          #               # #                                        
                        #                  # #   ##           #              #                       
                       #                        # # #                                                
                                                      #             #                           #    
#                                              #     ##  #   #                #                      
                 #                                    #    #        #             # #   #            
                                                      #   #         #                                
                                                     ## # #             #                #           
                           #                  #          ##                       #             #    
                                                 # #                                                #
                                               #    ## ## # #      ##    #                   #       
     #              #          #    #         #  #  #     ###                                        
                                                  #   #             #     #                          
                                       #          #  # # #                         #                 
                                                        # #         # #                              
                                                   #                #                                
       #                                         ##        #                                 #       
            #                                         #                                              
     #                                         #   #        #                                        
                            #         #         ###  ##             #                                
                             #        #          #     #              #                              
                                                       #                                             
                                               #     ####                               #  #         
                                          #         ##  #                                  #         
                #    #             #  #           #    #                             # #             
             #                          #      #              ##    #                                
                               #               #  #         #           #                            
                                                ##                                                   
                                            #        #   #                                           
                                      #         #                                                    
                                                                                                     
                                             # #    #      #                                         
                                                      #             #                               #
                          #           #  #       #                                                   
                                                       # #                                           
                                                   #  #   #                                          
 #                                    #           # ##          #       #                            
                            #                             ##                                         
                                               #    # #                            #                 
                   #                                ## ##                                            
                         #      #              #    #   #                                            
                         #            #            #  # #  ##    #                                   
#                                     #                  #                    #                      
                                   #  #     #       # #  #  #     #                      ##          
           #                          #        #     ##  #          #                                
                                      #                             #                                
                                      #            #  # ##                                           
              #    #                           #      #             #      #                         
# #                                               #        #            #                            
   #                                              # ##  #                 #                          
                   #                                              #                                  
                                      #      #      #   #                             #              
     #    #      #                  #         #                     #   #                            
                                      #      #       ##  #                                           
                                      #    #      ##      #         #                                
                               #      #           ##     ##  #  #                                    
                                      #      #         #            #                              # 
                                                     #              #       #                        
 #                                    #   #     # # #       #    #  #                                
                                    #               #      #                      #                  
                                      #             # #      #                                       
                                                ## #                           #                     
                              #                ##       ###         #                                
                                      #         ## #       #                                         
       #                                              #                                              
    #                                        #               #                                       
                                      #       #  #   # ##                                            
                                                                                                     
        #                                        #     #            #       #                        
                                                #                    #    #                          
                                                  #       #                            #             
                             #                     #                                                 
                                                 # # #   #                           #               
   #                                                #  #                                             
                                                     #                       #     #                 
                                                 #          ##      #                                
                                                # #           ##                                     
             #       #                        # #      #                                             
  #          #                                       ##                                              
                                         # #        # # #    # #    # #                              
                                                # # #    #          #                                
          #                                     #                                              #     
 #                                   ##                #                                             
#                                                  #               ##        #                    #  
                                      #    #         #    #         #                                
                                      #            #                #                                
                                      #              #  #   # #                                      
                              #       ##        #  # #    #           #                              
                                      #    #          #  # #                                         