
                                               #    #                                                
                                      #            # # #                                        #    
                                                  #   #             #                                
                                      ##           # #           #  ##                               
                                      #           ##  #  #                                           
     #                               #                #    #                                         
                                              ##      #      #                               #       
                                                                           #         #             # 
                                               #  # ## #            #          #         #           
                               #                   # #  #          #                                 
   #                                  #            #                                                 
       #                              # #        #         #                                         
                                                  #       #                                    #     
  #                         #         #          # #     #                                      #    
                                             ##             #       #     #        #                 
                   #                  #            # #          #                       #            
                                              # #    #   #          # #                              
                                         #           ##                                             #
                                                           #        #                                
                                                ##   #   # #                                         
                 #                              #  ### #                                             
 #                                              ##  # #                      #                       
                         #                      #  #   #                                             
#                                                   #                     #                          
                   #                            ###  #       #                                       
                                      #         #     #            #  #                              
                                             #      ##    #    #             #                       
                                           #        #                                                
                 #                               #    # #        #  #       #                        
                #                                     #                                              
                              #                     #                    #                           
                                                          #         #                                
                                                   #  #             #                                
    #        #                        #             #   # #                                          
                       #              #       ## #  #   # #         #   #    #                       
                                    # #        #  #  # #                                             
                                                    #   #           #   # #                          
                                                 #   #    # #                                        
                                      #        #   #    #                                            
                                      #               #  #   #      #                                
                                      #                 #           #                                
                                                           # #      #   #                            
                                   #                 #      #       #                                
  #                                #      #         #               #                                
                                            ## # #  #                                        #       
          #                                            # #                              #            
                                           #    #              #                                     
        #                             #              #     #     #                                  #
 #                                            #  #     #            #                                
          #                                #     #   #                                               
                                                       #####                                         
                                      #        #       #                #                            
                                                  # #                                                
                                                  #    #   #                                         
                                      #            ##   #    #                            #       #  
                                                ###      #                                           
                                                                    #                                
                     ##               #             # ##    #     #     #         #                  
#                                           #    #  #   ## #                                         
                                                 ####   # #                                          
                                      # #               #    ##                            #         
                                      #  #      #             #                                      
       #                                           # #      #                     #                  
                                                              #     # #                              
                    #                 #        #   #  #                                              
                                                  #     #             #                              
             #                                   #  #  # #                                           
   #                                  #             # #                                              
                                      #       #    # #                                               
                            #  #      #     #   #   #   #  #                                         
                                      #                # #            #                              
#                                          #          #     #       #                                
              #                 #                     # ##                                           
     #                                #         #       #                                  #         
                                                  #  ###        #   #               #                
                                    # #     #    #             #                   #                 
                                                  #       #                            #             
                     #                    #   #             #         #                              
                                   ##     #     ##   ##                                      #       
                         #                         # # ## #                        #                 
    #                   #             #    #           #          #                                  
                                                     ##                                              
                                                # #   #                                              
           #                 #        #        #            ##      #                                
                                             #   #          #       #                #               
                                                       #                    #                        
                                                         ##         #                                
                                                    # ##                      #                      
                                               #                                                     
                                                   #                                                 
                              #                    #  ##  #                                         #
                                                  #     #   #                                     #  
                                             #   # # #     #        #                                
     #             #                                                #                  #             
#                                                   #    #                                           
                               #               #         #  #                                        
                                       #          #       #         #                                
                           #                       #   #   #        #                                
                                                          #                              #           
 #                                    #                  #     #    #                 #              
                          #                   # #   #                                                
             #               #               #     #                      #   #                      
            #                                                 #                                      