
                                      #          #     ###                                           
       #                                                   #   #    ###                              
                 #                    #             ##       #      #                 #              
                                                      #                                              
#                                     #    #                        #                                
                                                         #                                #          
                                                                                                     
                                      #        ##  ##   #           #                                
                                            #       ##  #        #                                 # 
                                   #          #   ##                              #                  
                                             #       #                                 #             
          #                                                  #      #               #                
                                      #        # #           #                #                      
                                                     #  # # #       #                                
                                      #       #  #       #                                           
                                      #  #       #      #  #                                         
                             #         #                #    #                                       
                                                   # #                               #               
                                      #        #    ###                                              
     #       #         #                           #         #                                      #
                                             #   #                  #     #                          
                                                         #                                           
                                                      #               #                             #
                                      #             ## #                #                            
             #                        #         #        #          #                                
                                                            #            #                 #         
                                   #                  #                 #                            
                                      #       # #        #      #   #                             #  
#                            #                     # #     #                                         
                                                    #   #   #                                        
                                      #    #     #       #                                           
                                                #      #   #                #                        
 #                                            #       ##  #                                          
     #                                #           #   #             #                                
                                                   #          #     #        #         #             
                      #                                 # #           #   #  #     #                 
                                                  #   ##            #             #      #           
                                                  # #                                                
             #                             # #  ##   # #                                     #       
#                                   #               #     #         #                                
                                            #   # ## ###  #         #                                
 #                       #            #            #     #                                           
                                      #                   #                        #                 
                        #             #    # #   #                                                   
#   #                         #                        #    #           #                            
           #                          #      #   #             #                                     
                                         #    #  #                                                   
                                                  #                                                  
                                      #        #  ### #                                              
                                                    #                                                
                                          # #         #     ##                       #               
                     #              #        #         # # #          #                              
                                                   #        #              #                         
          #                                    #       #                                             
                            #                  ##   #                                                
                                      # #  #       #    #                                            
                                      #        #    #                                                
   #                            #                #      #  #                                         
                                      #            #    #           #                      #         
        #                      #          #    #              #     #                                
            #                         #           #   #             #                        #       
                                                        #                                            
    #                          #                #    #    #               #                          
                                      #                             #             #                  
                            #                      #    #           #                          #     
                                                 #  ###  #                                           
                                                  ## #              #                               #
                                                                                                     
 #                                    #         # ###       #  #                                     
                                              ##          #         #                                
                                      #            #                                                 
                               #                ### # #             #                                
                   #          #                  #    #   #                                     #    
                   #      #        #                     #         #               #                 
                                                 #        #                                          
                                                 #   # #  ##                                         
  #                                                    #                                             
                                                  #     #     #                                      
                                    # #   #   #     ###     #     #                                  
     #                                                 #                                             
              #                                   #  #    # #     #       #                          
                                                    #         #             # ##         #           
                                            #          #            #   #                            
                    #                              #      #         #                           #    
       #                                                 # #          #                 #            
                                                                   #                                 
                           #                    #  #   #                                             
                                              #  #   #          #   #                                
                #                                 #   #  # #     #  # #                              
                                               ###   ## #  ##                                        
                                       #       #      ##            #                                
                                                  #       #                                          
                                      #           # # #  #                              #            
                                                    #                                                
                 # #                    #        #   ##             #        #                       
                                                #  ##     #         #   #                            
  #                  #                                # #    #                               #    #  
                                      #                #            #                                
   #                                 #          #  # # ###                                           
                                      #            ##       #    #                                   
                                      #              # #                                             
                         #                        #        #                                         
                                      #           #        #                                         