
                                                 # ###      #       #                                
                                      #      #  #                             #   ##                 
                                                         ##                                          
                                               #   #                                   #             
                                               #     # ##                                            
                               #      #            ##  #    #       #                                
                                    #                   #  #      #                                  
                                         #         #  ##                                             
                                                      #        #   #                                 
                                                    # #     #                       #                
                                            #    # # ##                                              
                                          #   # #   ###   #           #                      #       
             #           #            #       #         # #                           #              
 #                                    #          #      #                    #                       
                                                  ###   ##                               #           
                                                                                                     
 #         #                   #      #              ##  #  #       #                                
                                                  #      # #                                         
                                                #   # #   #         #                                
                                      #               # # ##     #                                   
                                                     ##       #     #              #                 
#                                     #                #            #                                
                                           # #   # #        #                                        
          #                                        ###        #                                      
                                                  #                        #                         
                                      #     #        ##             #   #                            
                                                  #                                                  
                   #                                      #                                          
  # #                     #                       ##       #              #                          
                            #         #           #    #            #                               #
                                      #      #      #    #          #     #                          
                               #              #            #                   #                     
    #                           #  #  #    #                #        #      #                        
     #       #                                  # ## #                                  #       #    
       #                                           # #   #          #                                
     #                                #             #  #      #                                      
                              #       #       #  #          #  #                                     
                                      #      #  #     ##            #                                
                                               #                                                    #
                              #                  #  ##                                               
                                                      #      #  #                            #       
#                    #                          ##  #   ##                                           
                                                   #                                                 
                                      #              #                                               
                                             #  # #   ##                    ##                     # 
                                                       #  #  #        #                              
                    #       #                                 #                                      
                                     #         #                #                            #       
                                                       #                                   #    #    
                #  #                                #     #         #                                
                        #                  #        #                                                
                                            #     #                      #                           
                                                #                   #                                
                                               ## #    #                #            #               
                                                 # # #    #                                          
                                                        ##                                           
                                   #              #                                                  
                                                                                                     
                                      #          #    #                           #                  
              #      #                                   # #                                         
                                         #                                                           
                         #            #          #   #    #         # #                              
                                      #                               #                              
                                      #                                                              
                                      #                #            #                                
     #                                          ##       # # #                                       
                                                    # #     #       #                                
 #                    #                            ## #                                              
                                                     ##             #                                
                                                  #       #                                          
                                                   #   #   # #      #                             #  
       #                              #        #       # #          #     #  ##                      
                                       #   #            #           #     #                          
                                                 ## ##  #                              #             
                                                     #                                               
                 #                            #        # #  #       #                                
#                            #                        #             #                                
                                              #         # # #       #                #               
             #               #                 ### #    ##     #    #                                
        #                             #                 #             #                              
                                      ##             ##      #   #                                   
   #                                #                                                                
                                    #   #       #                  #                           #     
                                      #        #   #   #  #                                          
                                      #             ###           #                                  
                                                    #            #  #                             #  
                                      #        #  # #      #        #                                
                                      #     #       #        #                           #           
                                      #                ##                                            
                                      #             #  ##  #        #                      #         
                                                 ##                 #   #                            
                                      #      #    #      #          #   #                            
                                              #   #                                                  
            #                         #        # # #  #   ##                                         
          #                             #               #           #                                
                                              #    # #                                    #          
                                          #                             #               #            
  #                    #                   #                 #                                       
                                               # #    #        #                                     
                                                 #     #                          ##                #
                                   #           #        #                                            
   #             # #                  #         #   #    #                                           
#                          #                    #  ##   #             #                              