
                                      #  #               #          #                                
                                      #                                                      #       
##            # #                              #      ##  #                 #                        
                                      #           #    #    #       #                                
                                                 #                                                   
                                      #    #     ##                                                  
            #                         #      #                                                       
                   #                                ##     #                                      #  
                                           #   #    ####       #                                     
#                                                    ### #                #       #                  
                                      #                     #                                        
     #                                #        #  # ###   ##                                         
                                      #             ##                                               
                           #          #                     #   #   #     #    #                     
    #     #                                  ##    ## # #                                            
             #                                  # ###    #         ##                    #           
       #           #                               #                                         #      #
                 #                             #   # #                               # #             
                                       #         ##                                                  
                                                   #    #           #                                
                            #           #           ###   #                             #            
                                              #   #                 #                                
                                      #       #                                                      
                 #            # #     #      #             #     #                                   
#                                                             #                                    # 
                                      #      #          #   #                                        
                         #                        #     #           #        #             #         
     #                                           #  #                                                
             #                                    ##   # #          #                                
                              #                   #   #             #                                
                                                  #  #   #  #                 #                      
                                    #                    #                                           
                                               #       #    #                                        
                                                #   #  #     #      # #             #                
                                                   # #     #                                         
                               #      #        #      # # #         #                                
                                              #       #           #                                  
                                                 #  #                                                
                                   #    #       #   #   ##              #                            
                                                                                                     
 #                                    #               # #      #                                     
                                     ##           ## #              #   #          #                 
                                                   #         #      #   #                            
                                                      ## #    #                                      
#                                     #          ##  #     #        #   #                            
        #                           # #         #      #  #                               #          
                                                   #  #           #                                  
                                               #   #      #                                          
                                                #                        #                           
                                      #             #               #                                
                                            #  #      #     #                                        
                         #                       #                         # #                       
                                                        #                          #                 
                          #    #                    # #   #                                          
                                   #             # # #        #                                      
       #   #                          #     #   #     #  #                              #            
                            #         #             # ##                                        #    
                                                          #                                          
                     #                #            #      #                                          
                                      #   #     #      #            #        #                       
                                                #   # # #                                            
                                      #     #       #                                               #
                                      #                 #                                            
                                   #         #    #    #                                             
                                      #   #      #       ##         #                                
                                                    #    #          #     #                          
                                                   # #  #  #              #                          
                                      #          #     #           #                                 
                                                      # # # #       #                                
                        #                  #        ###             # #                              
                                                     #                #                              
     #                                         #        #                                            
                                                ###        ##        #                   #     #     
                                                  #     #           #                             #  
                   #                  #       ###       #           #                                
                                                       #                                             
                                               #   #                  #                              
                             #                  #      #                                             
                    #                           ##                                 # #               
 # #                                                  ## #                        #                  
                                                 #      #      #                                     
                                    # #          # ##     #    #    #                      #         
                                                     #    ##        #                                
    #                                      #         #              #                                
                                             # # #                                                   
  #       #                                   #    #          #                                      
                                                    #       #                                        
                                                ##       #                             #             
   #                   #                        #         #      #            #   #                  
  #                                               #    # #      #                               #    
                                                     ###            #                                
             #       #                      #      # #  #    #                                       
                                                #     #    #                                         
                                                                      #                              
                                          #           #      #              #                        
                      #                            #     #   #      #                                
                             #                   #  ##   # #                                         
                                      ##      #     ##  #    #          #                            
                                         #        #    #   ##                         #              
                               #                                    #                                
                                              ###                                            #       
                                                        #             #                              
                                                    ## #         #                                  #