
          #                           #        #   #      #                                          
                                              ##   # #                                               
   #                                    #      #     #              #        #                       
                                                     #              #                                
            #                         #               #                                              
                                              #   #  #         #                                     
     #                                           #  ###   #             #                            
                                                 ##   #  ##                       #                  
#                                     #                  ##         #             #                  
                                              #   # #                      #                         
                                              # #   # #     ##                        #              
                                             #         #            #                                
                                                        #  #        #                                
#                  #                  #         #         #                                          
     #                                         #   #        #                                        
                                    # #      #     #                #                                
                                     #   #  #         #                                              
  #                           #       #          #    ##            #                                
                                      #           #      #   #                                       
                                      #          ##                                          #       
                                   #                #  ##                                            
                                                        #          ##                      #         
              #                       #           #  #           #                                   
                                                                                                     
          #                                        #   # #                             # #           
             #                #           #         #                                  #             
 #                                    #                      #                                       
                                                          #             #                            
                        #                  #         # #                  #                  #       
                            #                   #    #  ##          #                        #       
                                                  # # # #           #             # #                
                                      #                                                              
                                                       #  #                                          
                   #                  #       #       # #                                            
                            #         #          #    #    ##                                     #  
  #                                               #   # #           #                                
                                               # #    #        #                   #                 
                          ##    #                #    # ##                                           
    #                                 #               #             #                                
                               #      #          #                  #   #                #           
                      #                            # ##                                              
                                      #                           #            #                     
                                                 #   #         #  # #                                
#                    #                #    #    ##  #           #                                    
       #                              #                ##   #                                        
                                        # #       # #   ##                         #                 
                                                   # ###                                             
                                           #   #   # # #  #         #                                
#                                     #         # #                                                  
                                      #                   ##     #                                   
                                               # ##         #             #                          
   #                                         #                                                       
                                                    ##      #                                        
                                                       #      #           #                          
                                               ##  ## #             #        #                       
                                                ####  #             #                           #    
                                                   ## # ##                                           
       #                       #            #      ##                 #                             #
                                                 ##     # #         #                                
                         #            #     #      #                                                 
                                                #                   #                                
                   #                  #                  #              #                            
                                                #    ##      #     #        #                        
           #                          #     #        #         #                                    #
                             #                     #    #     #                            #         
                                      #                #  # #                 #      #               
                                             #      #   #                                            
                                                  # #   #            #                               
                             #        #   ##        ##  #                                            
                         #                                 #                                         
                                      #         #   #    #   #  #                                    
                                              #    #                                                 
                                   #                   # #  #       #                                
                                                       #                      #      #  #            
                    #                                ### # ##    #                                   
        #                                      #  ##       #                                         
                                              # #   ##  #   #       #                                
                                      #        #  # #  #            #                     #          
                                               ##   #    # #        #                              # 
             #   #                                       #   #               #                       
                                   #           ### #       #                                         
 #               #                                         # #                                       
                                       #                            #                           #    
                                                       #                    #                        
                                                 #    # # ##        # #                              
                                                     #                                               
                                               #                      #                 #            
                     #         #           #  # #    #                #  #                           
                                                  #  #                                               
                                                 #                                                   
                                                       #    #                                        
                                      #  #         ##                                                
     #                                #          #      #     #                                      
    #        #                                    #    #                                             
                                    #            #                    #                           #  
                                                                                                     
                                                #     ##            #                               #
                                      #              #   #                                           
                #                                    #     #        #                                
                                                          #         #                          #     
                                      #      #  ## ###   ##                                          
 #                                  #               #      #          #                              
                       #              ##     #     #  ##                #                            