
                                                   ##  # #                         #                 
                                            #      #     #                                           
                                                    #                                                
             #                        #             ##                                               
                    #                 #            ##  #            #   #                            
                                      #      #  # #          #    #                     #      #     
          #                                                                                          
                                             #                              #                        
                                      #          #     #                      #                      
                                                       #           ##                                
                                      #         #                   #   #                            
                                             #   ##     #           #                           #    
                                                  #                                                  
                              #         #          #                                                 
                                   #  #         ###    #                                             
#    #                                                 #                              #              
                                                   #      #                    #                     
                     #                              # #             #       ##                       
                                               #       #     #                                       
       #                       #                     #              #                     #          
                            #      #                 #  #             #      #               #    #  
                                                #                                                 #  
                                                   #      # #       # #                              
    #                                    #           #                #              #               
                                      #          #  ####   #                               #         
                                                      # #   #                                        
                                      #     #        #                                               
                #  #                   #                            #                    #           
                                              #  #  #       #                            #           
                                             #   #             #    #        #      #                
                               #                 #  # #  #                                           
                 #                                   # #  #          #                               
                                      #       ##     #              #                                
                                            #    #  # #   ###           # #                          
                                                  #     #                          #                 
                                          #       ##### #                                            
                                      #            ## #   #      #                                   
#                                                 #   #   #                                  #       
                     # #                              #             #                                
                                      #              #                                               
                                                  # #              #                                 
                                      #             #  # #                                           
                                     #         #   #                              #                  
                                                         # ## #                                      
                                    #                       #     #                                  
   #                       #                   #     #                #                              
             #                                                      #                                
                                      #               #        #                                     
                                          #         ###   # #       #             #                  
                         #            #           #      #                #                          
                                      #               # #                                           #
                                    # #        # ##     #                                            
                                                  #   ##            #                                
                                                    #     #     #                                    
                                                     #  #  #                                        #
                                               # #  # #             # #                              
                      #               #                  #                                           
                                              #    #          #     #                                
                                                      #      #                                       
                                               #     #    ##                                         
                              #       #          #      #  #                                         
                                      #    #       ##    # # #      #                                
                                                ##  #                                                
              #                       #   #       #                 #                                
                               #    #      #       #             #                                   
                                                  #                 #                                
             #   #        #           #        ##           #                                        
                                                #   #  #                                             
                                              # #      #                      #                      
                                                #  # #         #    #                                
                                      #           #  ####           #                                
                                                         #                                           
            #                                    #   #    #         #                                
 # #               #        #                      #       #        #                  #             
                                      #          # ##         #                              #       
                                   #          #                     #                                
                                #             #      # #                                             
 #                                     #         #   #                             #                 
                                                                                                     
                   #                       #      ##                                    #            
                                            #   # #      #          #                                
                                                   #                                                 
                                                   #      ##                                         
#                       #                  #    #              #                  #                  
                                                #        #          #     #                          
    #   #                             #          # #  ##     #                                       
                                                        ##                                           
 ##                                      #      #      ##   # #     #   #                            
                                      #          ##    ##  #                               #         
                                           #   #      #                                         #    
                                                        #   #                                       #
#                                               #     #    #     #  #                                
       #                                       #     # #  # #       #   #                            
                             #        #        #  # #     #                                          
                             #                   #       #   #                                       
                                      #        #                                     # #             
  #       #              #                       #       ###                                       # 
                                             #                                                       
                                      #               # #       #         ##                         
     #                                # #          ###  # #         #                                
           #                          #             ##                   #                           
                                               #      ###                                            
     #                                       #      # # #                                            