
                         #                     #   ## #    ## #               #                      
                                              #    #    #     #     #                                
   #                                                            #            #                       
                                                     #                                              #
           #                          #       #                       #                              
                                                  #    #       #                                     
                                        #        # ##  #                                          #  
                                                # #  #  ##                                           
                ##          #                  #   #  #                                              
                                                      #     #           #                            
                                                      #  # #                                         
#                               #   # #         ##  # #                 #              #             
                     #                #              #      #       #                    #           
                                                  #                                                  
                                                    # #        #    #                                
                                               #            #                                        
                                                ###                                                  
                             #     #  #          #  #    #      #   #                                
                               #      #              #    #         #   # #       ##                 
             #                                    ##                                                 
                                                    #                                                
                                                #        #                                          #
                                                    # # #                                # # #       
#                                                  # ##                                              
                                   #  #          # #     # #                                         
                                      #  #                            #   #       #                  
                                            #      # #   #          #                                
                                                        #  #                                         
                                                           #        #   #                            
              #                       #    #        #  #    #                                        
                                    # #               ##                                             
                                              #     #       #       #                                
                                      # #         #  ##             #                                
  #                                  ##   #   #      #   #                                           
        #                             #      #   #       #                                           
#                           #                       ###                                             #
                              #                    #  #                                              
                                      #                # #          #                   #            
                   #                           #  #   #   #  #                                       
                                               #   #      #  #                                       
                                      #                             #                                
                                                  ##    #  #                          #              
   #                                  #         #   #               #         #                      
                                                 #                                                   
                             #        #   #      # #    #                #                           
     #                                                  #   #                        #     #         
                                                  #                 #                                
                                      #       #### #   #   #                              #          
    #                    #                   #     #                #                                
                   #                   #             ##                                              
                                                 #      ###         #                                
                                      ##                   #                                         
 #                  #     #           #              ##   ##                                         
     #                                           #  #                                                
                              #       #    #  #    #    #                         #                  
                                                 #  #  #            #                                
                                                         #     #                                     
                                                       #     #                                       
                                      #    #                 #        #            #                 
                                               # #     #  #               #                          
                        #                  # #         #                           #                 
                                                #      #            #                                
                                                # #                                                  
                                      #          #    #     ##     #  #                              
    #                                                 #                                              
                     #                #                           #   #     #       #                
                           #          #       #  ##  #  #                                          # 
                                               #  #    #  #                                          
       #                       #              #     #                                                
  #                                              ## ####                                #            
#                                  #           #  #   # #           #                                
                                                  ##   #  #                                          
                                           #      #   #                 #            #               
                                                   ## #                                              
             #                                  #    #              #                                
                   #           #                        #  #      #                                  
 #                     #              #     #      ###       #      #                                
                                                ##                 #                              #  
                                                     #        #     #                                
          #                                     #   #       #       #                                
                                      #  #     #        #                                            
                                            #     #     #                                            
     #                                                   #          #                                
                                            #     #  # ###                                           
                                                                    #                                
                                                #              #    #                                
                                                #  #      #                  #                       
                                      #                #   #        #      #                 #       
                                      #           #     #                                            
                                                 #   ##             #                                
             #                        #   #               #               #                          
                 #                                  ##  # #         ##                               
                                               #                 #          #  #                     
                                      #                 ##                   #                 #     
                                                    #        #                                       
 #     #                              #                # #          #                           #    
            #                                   #    #                #                #             
                                                   #   #  ##     #                                   
                      #                      #      # ##    #                                        
          #                                     #         # # #     #                                
                                    #        # #         #                                           
                                               #                                                #    
                                             #       ##   #         #                        #       