
                                              #          #          #                                
                                                     #   #                                           
                                                                                                     
 #                                              #                         #                  #       
                                      #            # # #                                             
          #                                         # #                                              
                                             #     # ##                                              
          #                           #  #                 ##       #                                
   #                                  #           ###    # # #   #                                   
                                           #       #   # #                               #           
                                   #  #         #  #           #  # #                                
                   #                              ####                                               
       #         #         #         ##              ##   #                                          
                                   #                        #         #                              
                                                ##         #              #                          
    ##                                                 #            #              #                 
 #                                         #    #     #                                              
                                      #                                 #                            
        #                                         #        #                                         
                                             #       # ##                                            
                     #                           #   #     #                                         
             #                                      #      #                           #             
                                                 ##  #                                               
                 #                                   ## ##     #    #        #                       
                                   #             #    #       #     #                                
                                      #            # #               #                               
#                                                  # #  #  #       ##                           #    
  #                                           #  #       #   #             #      #                  
                            #               #    #   ##  #                                           
                                           #                 #                 #                     
                                                #  #  ##                                     #       
                                #                   ##              #                                
       #                                           ## #                                              
                                                      ##  #         #   #             #              
 #                                             #           #    #                                    
   #                                  #                                                              
                                                  # #                                             #  
                                      #       #   #                 #                                
                                              #  #  #   #           #                                
                                                       #                                             
                                      #          ##   #                                              
                                           #     #    ##    #       #        #                       
                                        #                 #                  #                    #  
                               #      #        #    #  # #            #                 #            
                                                    ##         #    #                               #
                                             #       #       #      #   #                            
                                               #      #   ## #      #               #                
                                      #            # # ##           #                               #
                                      #           #       #         #              #                 
            #                                 #        ##                            #               
                               #            #    #    ##                      #                      
                                      #        ##  #    #    #   #        #       #                  
                                         #    ####  ###  #                                           
                                      #        #      #                                              
                                                #                                                    
                                      #                  #          #                                
                                                         #                                           
                                                    #   #                                            
                                                  #                                            #     
#                                   # ##              ##            #     #                          
                                                       ##           #                                
#                   #                          #   #    ####        #       #                        
                                      #                   #                                          
                                      #         #     #             #       #                        
                                      #                 #             #                              
                                             #      ##      #                                       #
                                    #  #  #    ##                   #                                
                                      #        #       #                                             
             #                        #                                                              
                                      #   #        #                                                 
                            #                 #   ###                                                
                                               #              #  #                                   
    #                                       #    #    # # #                                          
                                                  # #    ##   #                                      
                     #                               ###  #                                          
                        #                  # #     # #     #        #                                
                                                   #  #                                              
                               #    # #        #    #     #                                          
                                      #          #    # #   #       # #                   #          
                                      #              ##   # ##                           #           
                         #   #                  #     #                                 #            
             #                #           #        #    #           #                  #             
                   #                              #  #  #                         #        #         
     #                        #                     #                                                
                                      #            #   #            #   #                            
                         #                      # #  #                   #                      #    
                                                 ##    #           #                       #         
              #                                 #      # #                                           
                          #           #           #                                                  
           #                          #                ##       #   #                                
                                                    #   #           #                        #       
                                      #        ###            #                                      
  #                                                 #       #                                        
                      #                                     #       #                                
                                      #      #          #                                            
                                                   #                                                 
                       #                            #      #   #    #                                
                                               #         #            # #          #                 
                   #                    #                                                            
#                            #        #           ##    #   #                                      # 
                                                 #     #    #                        #               
     #          #                           # # # #  #              #                                
                                                    #             # #                                