
                   #                  #      #   #    #                      #                       
       #                                            #    #                                           
                                                  ##       #                                         
                                   #      #      #   #    #                                          
                                                  #  #  #                                            
                                      #            # ##                                              
              #               #                     ##                                               
                                      #                #                                             
                             #                           #                                           
                                      #          #   # # #          #                                
                                                     ##             #             #                  
 #                                        #      #         # #      # #      #                       
                                                    # # #                                            
                                              #### #                                                 
                 #       #                      #    ## #                                            
                                    #                 #                                              
          #  #                                    #  #                    #                          
                                                 #  #     #         #   #                            
                                   #               #   #                                             
                                      #            #   # #    ###   #                               #
                                                #   ####            #   #                            
                                                                                                     
                                      #            # #              #      #                         
                                                  #   #   #         #                                
                                      #          #   # ##  #        # #                      #    #  
                                               #   #  ####          #                      #         
                                                  ## #      #         #                              
                                              ##      #   #                                  #       
                                                   ##                             #                  
                       #                        #   #   #                                            
                            #         #       # # #   #      #                     #                 
                                                                                                     
                         #            #     #     #       #   ##    #                               #
                                                #          ##       #                                
     #                                     #            #                                            
                                                #     #  #              #                            
           #        #                ##           #   #      #                                       
                                        #        #     #              #       #                      
                                      #          #    ### #                             #            
                                      #                          #  #                  #             
                   #                             # #                               #                 
             #                                 #       #    #                                        
                                             #   #  #  #    #             #                          
   #                                      # #   #       #                                            
                              #                #     #    #  #  #                                    
                                      #        #                  ###                             #  
                                                     #                                               
                                                    #                                                
                                                                                                     
                     #                            #        #        #                                
                 #                    #                #            #             #                  
#       #                             #                             #                                
                                            #     # #       #       #                                
                                                ##      #                           #               #
  #                                           # #                   #                  #             
                     #             #  #            #      #                                          
                                      #       #      #              #                                
                                      #          #     ###          #                      #         
                                                   #    #           #                    #           
 #                 #       #                     #  #        #                                       
   #                           #        #     # ###   #                                              
                                         #     #                                                     
#                                                   #    #          #                                
                                    #                                        #                       
     #                      #                  ###  ##   #                                           
                                           #        ##         #                                     
                                             #           #                                           
                                #            #     # #                      #                   #    
          #                                      #        # #       #                                
             #                      #              #                                                 
                                                   #    #  #                                         
    #                                 #             # #  #  ##       #                               
#                                     #               ##   #                              #          
                                                   #    #   #       #                                
    #                                        #     #                                                 
  #                                        #                        #                                
       #                               #          # #  #   #                                       # 
                                                      ##    #           #                            
                                               #       #                                             
                                                #    ##  #            #   #                          
                                         #     #     ##   #                 #                        
                                                    #   #           #                                
                                      #            ## # # # #                                        
                #                                 # # # #                                            
                      #                            #                                                 
                                                 # #   # #  #                 #                      
#                                                 #  ##          #  #                    #           
                               #                          #             #                            
            #                                  #          #                                          
 #                                    #         #   #    # #                                         
                                                                                     #               
                          #                          ##      #      #                                
                                      #             ##                             #                 
                                      #         #  #                  #                              
     #                                ##        #    ###      #                                      
                             #        #      # # #  #      #  #  #                      #            
                                      #                 #           #                #               
                                            #       #                    #                      #    
                                                                                               #     
                                                                  ###                        #       
                                      #    #       #                                                 
                               #              #   #       ##   #               #      #              
                        #                  #           #                                             