
                                      #   #      #  #       #                              # #       
                          #                    #       #            # #        #                    #
                                                 #     #   #                                         
                                                                                                     
       #                                          #   #           #                                  
                #            #                     # #      #                     #                  
                                                 # ##                                                
                               #                         #                                           
                                      #          #         #                                         
   #                         # #                  #   #  #          #                                
       #                                     #      # #  #                           #               
                                      #       # ##                                                   
                                          #       ##   #  #                                          
                        #               #  #    #   #                                                
    #                       #         #                   #                  #         #             
                                   #        #    #         #                  #                      
                                      #          #   ##                                              
             #                  #               #     ###                                            
                                              # #     #                               #              
                                                 #                  #                                
                                      #         #  #   ## # #       #                                
                                    #              ##               #        #                       
#                                             # #       #     #                                      
                                                        # #                                          
                                                                                                     
                                               #         ##  ##     #                                
                                                ##   ##   #         #     #                          
 #                                                    ##     # #                                #    
                   #                                 #              #   #                            
                                                  ## #     #                                         
                                                 #  ##               #                               
             #                     #           #    ##   #                                     #     
                                            #                       #                                
                                           #        # #  #          #   #                            
                                                         # ##       #                                
                     #                # #           #        #                                       
     #                                #                 #    #            #                          
                         #           #                              #                                
                                                      #   ##                                         
    #                                         #      ##            #                                 
                                      #                      #                         #             
                                      #        #         #                                           
                                                  # ##    #                              #           
                                                             #                                       
                                      #       #    ##                                                
   #                  #                           #  #   #                                         # 
                                    #          #      #  #               #                #          
                                      #           ##                  #                              
                                      #              #           #    #            #                #
                                                   #  #    #                        #                
                                                       #                                             
            #                                             #   #     #                                
                                              #    # ###    #                                        
                                                 ###    #       #   #                                
                                             #    #     #                                            
                               #                     #    #                        #                 
                   #                       #          ##    #                                        
#                #                           # #      # #                                            
##                                              ##  #  #  #    #    #                             #  
             #                                          #   #   #                                    
                                               #       #  ##     #                                   
  #                                                                                                  
     #                                                     #                            #            
                                                                                             #       
                 #                    #  #    #  #          #         #                              
                    #                                               #     #   #                      
                                                    #  ##                                            
              #                                 ##  ##              #                                
                                            #          #       #                                     
                                                #      #   #        #      #                         
                                                 # # #                                   #          #
                                                   ## #  #                                           
                                                    # #     #      #         #                       
                                                    #  # #                                           
                                      ##                     #                                       
#                                     #       #    # ###                                          #  
                                      #                             #                                
  #                      #            #   #           #                                              
                     #                                                  #                            
                                                                      #                              
                                      #         # #   # #           #                   #            
           #                  #       #    # #       ## #   #       #                                
                       #            # #         #      #            #                                
                                                         # #   #    #             #                  
                                      #                             #                                
                                       #       # ##                 #       #                        
                                      #        ## # ##  ##          # # #                            
 #                                 #         # #        # ##                               #         
                                                   #                                                 
                                         #           #                                               
                                      #    #                     #                                   
        #                  #          #      #                      #                                
          #                                     ##          #       #                           #    
                              #                        #                    #                        
                                                       #      #     #                                
                                            #           #           #                                
                                      #        #  ##                                 #               
                   #        #                    ### #  #                 #                          
     #    #                           #         #   # #                                              
                                                        #                                            
                                               #                                  #                  
                                               #  # #  ###                                   #       
                                      #           # #                              #                 