
                                                     ## #           #         #                      
                                      #                                   #                          
                                                      #                                  #           
                                            #  #       ##    ##                                      
          #                                                                                          
#                                                #  # ##  #     #     #                              
                            #         #                 # #         #                    #           
                        #                  #         #     ##                                        
     #      #                                #  #  #         #      #              #                 
                #               #      #         #       #               #                        #  
                                                 # #               ##             #    #             
                                                 #   # #                                             
                                         #         #    #                                            
                               #                 # ###                                    #  #       
                                                    ##   #                                           
        #                                    #           ##                                          
                                               ## #                                                  
                                                     # #     # #    #                                
                                      #             #  #   #                                         
                               #              #  #  # #     #                                        
                                           #  #   #        #                                         
                             ##       #       # #   ##   #   #                                       
   #                                        #  #       #                                             
                                      #               # #   #       #   #   #                     #  
                                      #             ###  #       #          #                        
    #                                                   #                         #                  
 #                                                #    #              #                              
                                                           #                                         
                                   #  #            #                #                                
 #                                    #             #                                                
                                                        #         # #                                
                                        #         ###   #           #                      #         
  #                #                       #  #      #                                               
                                                  #       # #                                        
                                                 #   ##                                              
                                             #                      #                                
                                                        #                           #                
                                       #    #   # #   # #                               #            
    #                                   #         #   #  ##                                         #
                                      #       #        # #                   #                      #
#                                         #      # #  #      #                                       
                              #                      #  ###         #                                
                                                #  #                                                 
                         #                            #             #   #                            
                                               #      #   #    #    #                                
                                           #     # ##               #                          #     
                                                    #   #   #                      #   #             
           #          #             # #                                                              
     #                                #         #     #   # #                                        
                                                    #               #   #                            
     #                                             #                                                 
                                            #     #       #       #                                  
                                                    # ##       #      #                              
   #   #                              #              # ##                                            
             #                     #                #  # # #                                         
                                      #                       #                                      
                   #           #   #  #             #   #      #    # #                              
                                      #                #                                #       #    
  #              #                                #     # #                                          
                                      #                                            #                 
                                          #      #   #  ## #        #                                
                                              #    #     #          #                                
                                                #     #   #                                          
                                                #  #       #                                         
#                                              ##    # # #                           #               
                                                   #      # #         #                             #
             #                       #     # ###     ##             #             #                  
          #                           #                 #           #                                
                 #                  # #         ###                 # #                      #       
                          #                           ##   # #                                       
                                               # #    #                                              
                                                    ##             ##     #                          
                                                 #   #                                               
                     #                              ##  #           #                              # 
                       #              #           # #                                                
                                      #           #  ####  # #   #                                   
                                      #            #       #                                         
                                         #       # # # # #          ##    #                  #       
                                               #  #       #                                          
                                                #   # #     #    #                                   
                                             #     #                                                 
                                                  #                                                  
 #                  #                 #                                                              
                            #                  #     #     #        #                 #              
                                                   #                                                 
              #                                          #              #                            
                         #            #                         #                                    
                                             #        ##      #                                      
                                                ##  #       #                  #                     
                                                     #   #              #                            
                             #        #        #      ##                                             
       #                                         # ##  #   ##                        #               
                           #        # #         #                                                    
                                          #    #                           #                         
                                      #         # #       #                                          
                     #                                 #                                             
                                                 ####  #            #                           #    
                                      #         #             #                                      
                                      #        #     #    #                   #            #         
                                      #         #                                                    
                                                    ##      #       #        #                       
                                      #          # #  #             #     #  #                       
                   #                                  #  #                                           