
                                   #                                                                 
                                      #                                                              
       #                                  #      ##                 #   #                            
                                    #              # # ##                                            
                                                        # #  #            #                #         
             #                           #         ##    ##         #        #                       
#                                     #             #                                                
                                      # #        #     # #          #                                
   #                                            #   ## ##             #                              
                                      #  #    # #  # #  #                                            
                                      #    #       #     #                                           
                                                   #        #       #                                
                                             #   #                                                   
                                      #          # #   # #  #                                        
                             #                 #         #          #                                
                                              ###     #                     #                        
                                                   # #              #                                
     #                                         #     #                #                         #    
                   #                                     ##                                          
                                             # # #     #                           #              #  
 #        #                                  # #   #  #             #             #                  
                                      #             # #                                   #          
                 #                                  #                         #         #            
                                                       # # #                                         
                                               #    # ##     #    #                                  
                                      #    #    ##  #               #                             #  
                       #              #    #          #         #   #                          #     
                                               ###        #                                          
                                      #              # #                                             
                   #                                   ##     #       #                              
                                      #           ###               #                                
                 #                     #           # #                     #                    #    
    #                                        #                #                                      
                #                     #   #     #    #         #    #                                
                                     #               #  #  #                             #           
                                      #    #             #                                         # 
#                                               # #                                                  
                                                    ##  #                                            
                              #                   #        #                                         
                                      #                #   #                                         
  #                                   #             ####     #   #                                   
#                              #      #                   #                                          
                                      #           # #     ###   #   # #                              
                                    #                   #      #          #                          
                                                         ##    #             #                       
                         #                    #      #  #   #                                        
                                                     #                                               
                                                                                                     
                                                         #                                           
           #                          #             #     ###       #                                
                                                    #              ###                               
                                                #  #       #                                         
                                            #     #                     #                            
                                                   #        #       #                                
                                      #           # ###      #      #                               #
                                              #  #   ##                                              
                                                      #                                              
                                                  #        #       #                                 
          #                           ##                                                     #       
            #         #                          ##       #    # #                                  #
                                                            #                                        
                            ##        #   #               #                         # #              
                                                         # #     #  #        #       #               
                                                ##  # #   ##        #                                
                                #     #       #            # #                                      #
                          #                 # #  #   #                                               
                                      #     #   #       #                                            
                                                 #    #                                              
                                                 #  # # #                                  #         
                                            #  #         #                                           
             #                 #      #            # #              #       #                        
  #                      #                     # # #                #                    #           
                                      #                             #   #                            
                              #                       ### #                                          
        #               #                  #    #                         #                          
                                                   #  #       #                                      
                                                   #                                         #       
                                                                                   #                 
                                                  #   #                              #               
                               #      #                                   #                          
                                                 #  #                                                
     #              #                               #                         #                      
                                   #              #  ##               #                #             
                                                 #  ##            # #              #                 
                                                #                                                    
                                      # #            # #            # #                              
     #                             #           ##                                                    
                                               #  #   # # #  #                    #                  
                                                  ##  # #           #   #                            
             #                        #               #                                #             
   #          #                              ## # ###        #      #             #                  
    #                                             #    #            #                        #       
                                                      #             #                                
 #                                    #        #         #                              #            
                   # #                                  #           #   #                            
                     #                        # #   #     #         #          #                     
                                      #        # #     #                 #                           
                                    # #               #  #    #                                      
       #                   #          #         #      #    #                                        
                                             #   ##  #  #           #                                
#                                                   ##  #   #                                        
                                                 #          #                                        
                            #                          #    #                                        