
                       #               #        #     #                                              
                                                   ####  #      #   #                                
  #          #                      #           # #       #         #                                
    #                   #             #    #       #               ##                                
                                   #            ##    ### #  #      #                                
                            #         ##             ## #                                            
                   #                                  #             #      #                         
                                              ###      #       #          #                          
                                                     # ##   # #     #     #                          
                                                    #       #                                        
          #  #                                   #       #                                           
                                                 ##   #       #                                      
                                                     # # #                                           
       #                                         # ###            #                                  
                      #             # #        ##      #  #                                          
                                             #     ### #                                             
          #        #                          #   #     ##                    #                      
                                               #  # #  #                                             
                                                      #                                              
                                                   #    #    #                                       
                               #                #   #   #  #                                   #     
                                           #      #    #   #   #      #                              
                                                   # #   #                                           
                                   #                 #              #                              # 
                           #                      #                                                  
                                      #       #    #                  #                              
                                                 #         #                               #         
                                      #               # #                                            
#                                              #        #                                  #         
                                      #             #   #                                            
                                                                                  #             #    
                                                    # ##         #  #                                
                                                  #                                      #           
        #                             #             ##                                               
                                      #         ## #      #                                       #  
             #              #                       #       #                                        
                                      #               ##                                             
                                                           #                                         
                                #               #      #   #                      #                  
                                      #         ##   #                                               
                                      #             # #                   #                          
   #             #           #               #     #  #                                              
     #                                #                 #             #              #              #
                                                   #                           #   #                 
                                                     #        #     #                    #           
                                                   ##     ##                #                        
       #        #                     #  #    #     #  #    ##                               #       
                                                 #           #      # #                              
   #        #                                                     # #                                
                                                                                                     
                         #            #    #        #       #       #        #     #   #             
#    #                               #                 #              # #    #                       
                                          #       #      #                  #                #       
                                                     #                   #                           
                 #                                                                                   
                                      #           ## ##  #              #                            
  #  #                                                 #  #         #        #               #       
                                                      #     #                                        
                                    # #             #      #       ##                                
 #                  #                          ##   ##  ##                                           
                               #      #           ## #   #  #                                        
                                             #    #      #                                           
                                                   #   #                #                            
#                                                    #   #              #                            
                     #                         #   ## #   #  #                                       
                                                 #   #                                               
                             #        #                    #                                         
                                                  #                 #                                
#                                                                                                 #  
                                      #  #   #   #  #       #       #                                
                                              # # #   #                                              
                   #                  #            #      # #       #                                
                     #                         #    #                                                
                                               #      #  #                                           
                                            #                        #                               
                              #                  #  #    #    #           #                          
                                               #    #          ##   #                  ##            
                                                    # ###    #                       #          #    
                                                ##    #             #             #                  
                                            #  #       #  #         #                                
                          #        #  #            ##                                                
                                                   #     #  #                                        
                                      #               #      #                                       
                                          #           #          #  #   #                            
                              #             #        ###            #                                
                                      #        #  #        #     #    #                              
                                      #     #                                                        
                                      #        #          # #                                       #
                               #      #                                                              
                         #              #     # # # #  #  #    #                        #            
                                                     #                                               
                                             #             #                                         
                                      #      #           #          #                 #              
           #                          #   #    # #     #                                             
 #                                              #       # #         #         #           #          
                                      #          ###       #                                         
                                      #                                            ##                
              #                       # #                           #                               #
 #                                            #    #      ##        #                                
                                           #  # #    #                                               
                                           #     #        #         #                                
    #                                 #             #   #           #                                
                                      #           ## #  #           #                                