
                                                 ## #               # #                              
                                               # #   #  # #   #     #                                
        #   #               #      #              #   #     #       #                                
                                   #       #          #        #    #                                
                                    #        ##      #                                               
                              #                                     #                                
                                                 # #               #                     ##          
                                      #                 #           #             #                  
                                                  #                                                  
                         #                      #   #  # #                                           
     #                                           #    ###        #                                   
                                                   # #                                               
                   #                              #      #          #              #                 
                       #              #             #  #  #                                          
   #                                              #    ##                                            
                                                     # ##  #   #                                     
                                                 #    # # #             #                  #         
#    #                                       #         # # ###                                       
          #                    #                                        #                            
                                               # # #   #     #                                       
                                              #     #                                                
                          #                    #                    # #                              
                                               #           #     #                           #       
                                            #   #  ##    # #        #    #                     #     
                                                  #                                                 #
                                                #  #                                  #              
                                      #        # #   #                               #               
                              #       #               #             #               #                
   #                 #                     #      #       #         #                                
                                                 # #  #   #  #                    #                # 
                                      #       #  #       #                  #                        
                                      #          #    # #           #              #   #             
                                                  #   # #      #                                     
                                                #  #     #   # #                         #           
          #                                           #                                              
                                                #       #  #        #                                
                 #                                   # ###        # #                                
                                         #      #  #                #   #                            
                 #                               #            #                    #                 
                                      #            # #                                               
             #               #                     #                                                 
                                      #         #   #                     #                          
              #                       #          #         #                                         
                                      #            ##        ##           #                          
                                      #         #            #                                       
                                              #  #   #           #  #                                
                                                #                                                    
                                                   #     ##         #                      #         
  #                         #                      #    #         #                                  
                                                # #   #  #                              #            
                   #                           #     #      #       #                                
                             #  #                    # ##       #                                    
#                                     # #     # #   #      #  #                      #               
                                               #       #  #                                         #
                                    # #                     #                                   #    
             #     #                                #    #  #                                #       
                                                  #### #  #                  #                       
 #                                             #     #                  #                            
                                                          # #       #         #                      
 #     #                                             #                                               
                                                                                                     
                           #          #            ## ##   #                #                #       
             #                        #               #              #                               
                                           ##    #           #                                       
                                                 #     ###                                           
                                                         #                                           
                                                        # #           #                #             
                         #             #          #         #                                        
                                      #                                                              
    #                                 #               #                        #                     
                    #                 #      #      #                      #                         
           #                          #             #  #                                             
       #                              #   #           #   #                                          
                                                                #   #                               #
                                            #    #    # ##          #                                
                                                   ##  #                                        #    
 #                                          #      # #                                               
                                      #               #                                              
                                      #           # #              ##                             #  
                               #      #  #          #                                                
                                                 #                      #                            
                                   #            #    # #                                             
                               #               #     ##    #                 #                       
                     #                 #       #    #  #  #                                          
#                                     #                  #          #             #                  
                                                     # #    #       #                                
                                      #                                                              
                                        #         #        ##         #                              
  #  #                #               #      #  #        #                                           
                                      #    #      ###     #                                          
                        #                  #        ###    #                                         
                #                     #      ###    #                     #             #            
                                                     # #                                             
                                      #         #   #                     #                          
                                     #    #         ###                                              
#                                              #  #  ## #           #                                
    #                                          ### #      ##        #                                
                                                   #  # ###                                          
                                                  #     #           # #                           #  
                                          #                 #       #        #                       
                                      #       #   #   #             #         #                      
                                                    # #     #                                        
                                    # #      ##                                                      