
                   #                                                                    #            
                #                              #       #            #                                
                                                   #     #                                           
    #                                 #         ##   ## #                    #                       
                                                                    # #                              
                                              #   #                 #                      #         
                                   #  #           #  ##             #                                
#                                                          #       #    #                            
             #           #  #        #           # ##    ##         #                                
                                               # ##    ##                                            
                                      #   #         #          #                                     
                                           #         # #            #                                
           #                          #      # #   ##               #                                
                                         #   #              #                                        
          #                         #      #     #    # #                                            
                                                 #   #        #     #                                
                                                 #          #                                        
                                              #     #            #             #               #   # 
                                      #        ##    ##   #                            #             
  #                     #                  #           ##                                            
       #                              #            ## # #                                            
                                      #          #    ##    #                                        
                            #                            #                                           
                                              # #                                                    
     #                              #            #    ##                                             
                                #     #           # #  #            #                #               
                                                #  #    ##          #   #                            
                                      #              #                        #                      
 #                                            ###         #  #        #                              
                                                #      #              #                              
                                      ##                 #              #    #                       
                             #                    #                #                     #   #      #
                                                       #     #  #                    #               
                                                      #     #                                        
 #                                    #    # #    # # #  #          #                  #             
                                                          #                   #                      
                          #            #     #           #                                           
                                      #        #  #                                                  
                              #                                     #                             #  
#                                       #            #  #           #                                
    #                                 #                 #                                  #         
                                                                                                     
 #                            #             #        ##               #                              
                      #            #  #           #  #                      #                        
                                                    #  #                     #                       
                                                #    ##    ##    #         #                         
                 #                                #     #      #    #                                
                                                  # ##                            #                  
                    #                          #   #       #        #                                
              #                       #       #    #####     #                               #       
                                                # # #         #                                      
                                               #     #              #              #                 
#            #                                     #  #                                              
                                    # #         #          ##    #                #                  
                                                #                                                    
                                                          ##        #              #                 
                                                  #   #                               #              
                                      #          #   #   #          #                                
                                                   #   # #                                           
                                                 #   #    ##              #                          
                                                               #  # #       #                        
                     #         #                #   #   #                                            
                                      #          #  ##                              #                
                                                         #                                           
  #     #                                        # #      ##        #                                
                                              #    #    ##  #                                        
                                               ###    ##                                             
                                               ###      #               #                           #
   #                                  #                 #                                            
                                                    # #   #                                          
       #         #                    #            ##   #  #                                         
                                                  # #               #                                
                                                #                     #           #                  
                                              #   #  ### #                                           
#    #                                           #     #                  #                          
                                             # #  # #   # #                                          
                                                   #      #                                          
                                                        ###  #                                       
                                                      ##     #            #                          
                                   #                 ###            #                     #          
                   #                               ##  #   #                                         
                                                   #     #        #                                  
                                      #               #  #   ##                          #           
             #                                      #                    #                           
                                            #               ## #    #   #                            
     #                                      #    # #  #  #                                           
                                      #                              #                               
                                      #   #         #                                   #            
                                                 #                  #              #            #    
          #                           #           #                                                  
                       #   #                    #  #       #              #                  #       
                         #            # #           #               #                                
                   #         #             #   ## # #   #                                            
                                             ##     #               #                             #  
            #                             #        #   #                                             
                                                  #   #     #       #                                
                                            #      #        #       #                                
                               #      #              #  # ##        #                                
                                      #           #   #       #                                      
                                      #            # #                                               
                     #                #                             # #                         #    
                                      #  #           #          #                                   #
                               #      #        #       #                                             