
     #                                #           #    #                                             
                                   #  #                 #  #                                         
                                      #          ### ##                                              
                       #  #                    #      # #     #                                      
                                      #           # # ##            #                                
#                                     #           #   #                                              
  #                                                       #                                          
                                                                                                     
                                                          #                                          
             #                                 #                    #   #                            
        #                                               #                                            
   #                                  #          #  #  #                                             
                                                        #           #                                
              #                       #           #  #  #      #                                     
                    #               # #  #          #               #                                
                                                      #    ##    #                         #         
                                            ##    #  #    #                       #                  
                                                 ## ##                                               
                                      #            #     ###        #                                
                                      #           # #                                                
                                                    #     #         #                                
                                      #         #   #                                        #       
                                      #  #               #                             #             
                                       #         #       #  #                                        
                 #   #                               ##  #   #                                       
                   #                      #   # #  #  #                                              
                                      #        #    #                                  #             
                     #                                     #                                         
                                      #         ##    ## #                        #                  
                                                #    # #          #                   #              
 #                                        #    #       #  #         #                                
                        #                 ##   #       #                                             
                                      #          #  ##                #                              
                                      #              # #  #                                          
                                               #     # # #          #                   #            
                                               # ##     #                                            
                            #              #       #     #                                           
                                             ## # #  #                  #                            
             #              #         #             ##        #                                      
                      #                         #  # #     # #                                       
#                                                 #                 #                           #    
                                #       #                   #                                        
    #                                                 #             #                     #          
                              #                    #  #  #                         #                 
                                                 #                  #                                
                                      #          #      # #  #      #   #                            
                                      #         #             #    #  #                 #            
                   #                    #              #    #             #                          
                                                #       #  # #      #                                
                                                 ####   #  #        #          #           #         
                                                    #  #                                             
                                              #  #   #                                               
       #                                    #    # #   #   #       #                                 
                                     ##            #    ##                                           
                                                         ## #            #    #                      
 #                            #                       ##            #                                
                                                #  #  #                                  #           
                                                     #                                               
                                   #             #       # #  #  #                                   
     #                             #       #  #    #                                     #           
                             #                    #   #                                           # #
                                           #         # #                                             
                                            #      ##               #       ##                       
                                       #     #      # # #                                            
          #                                     #     #    #   #                   #         #     # 
             #                        #                   #         #              #                 
                               #      #          #                                                   
                                                    ##    # #                                     #  
                                             #      #   #   #       #   #                            
                                      #            #    #         # #                                
  #                                                 ##                       #                       
          #                                       #   ##            #                                
                                               ##         #                                          
#                                     #            #    #                                            
                                                  #  #                                               
                             #                           ##    #    #         #                      
                         #                    # #         ##        #     #          #               
#           #                         #             #  # # # #                                       
                               #                     #  #                                            
                                                      #        #    #     #                          
           #                          #       #  # #                                            #    
                                                   #            #                                    
                 # #           #                        ##  #    #                                   
   #                                #                #      #       #   #                            
    #                               #                                                                
                                      #            ###                                               
                                      #    #   #    ## #                                             
       #                                                                                             
                           #                                          #             #                
 #                                                    #      #                       #               
                                                ##        # #                                        
                                             ###   #  #               #      #                       
                                                 # # #  #           # #                        #     
                                              #       # #           #                                
                                               #     #  #       #   #                                
                                               #   #  #              #                               
                #        #            #               ##                          #                 #
                                                #   #               #       #                #       
     #                                              #                                                
                                                   #         #                                       
                                      #          ##                 #      #                        #
                                                #     #                                              
                                                       #                                             