
                             #                                        #                         #    
#            #                                   #             #                     #               
                   #               #                                                                 
                                                                                       #             
                                                                        #                            
     #                                                                                 #             
                                                                                                     
                            #                   #                                                    
                                                                                     #               
                                                                                                     
            #    #                                                                           #       
                                                          # #                     #                  
                                                                      #                    #         
                               #                                                                     
                                                          #                                          
                                      #          #                            #                      
                #                                                                                    
             #                                    #                                                  
                                                                                               #     
                              #                                              #          #          # 
                                                 #    #                                              
 #                                                                                                   
                                                                                                     
#                                                                                                    
                                      ###############################                                
                                      #                             #                                
                                      #                             #                                
  ##                                  #                             #                                
                                      #                             #                                
     #                                #              #              #                                
                                      #             ###             #     #                          
                                      #            #####            #   #                            
                                      #           #######           #      #                         
                                      #          #########          #                                
                                      #            #####            #                                
                         #            #           #######           # #                  #           
#                                   # #          #########          #                      # #       
                                      #         ###########         #                                
                                      #        #############        #                                
           #                          #          #########          #     #         #             #  
                                      #         ###########         #                                
                                      #        #############        #              #                 
                                      #       ###############       # #                              
                         #            #      #################      #                                
                                      #        #############        #             #                  
                                   #  #       ###############       #   #                            
                                      #      #################      #       ##                       
                                      #     ###################     #                                
                        #             #    #####################    #                             #  
          #                  #        #             ###             #                                
 #                                    #             ###             #                        #       
       #                              #             ###             #              #                 
                                      #                             #                                
                              #       #                             #                                
                                      #                             # #                              
                                    # #                             #       #                        
#                                     ###############################                                
                                                                                                     
                                                       ##                                       #    
   #                                                                                                 
                       #                   #                            #      #                     
                                                                                                     
    #                                                       #         #                             #
       #                            #                            #            #                      
                                                                                                     
              #                                    #                                                 
                                               #                                   #                 
                                                             #                                       
                           #                                                          #              
     #                                          #  #                                                #
    #                                                                                                
                                                                                                     
                                                                                                     
                                                           #            ##   #                       
                                   #                                              #                  
                                                                                                     
                                                                                                     
                                                                                                    #
                                                                                                     
                                      #                                                              
                                                                                                     
                                               #            #                                        
 ##                                                                  #                               
                                                                                                     
                                                                                          #          
                   #      #                #                                                         
                    #                                                     #                          
                                                                                                     
        #            #         #                                                                     
                                          #                               #                          
                                                                                                     
                                     #                                                               
                                                                                                     
             #     #                                                                                 
                               #                                                        #            
                            #                                                                        
                                                                                                     
          #                                                                                          
                                #                                   #                                
                 #   #                                                                               
                                                                                         #           
                                                                                                     
                      #                         #   #                                                