
                                           #   #    #  #                                             
                                                # # ###                                      #       
                   #                  #        #   ##  # #     #    #     #            #             
                                                # #     #           #                                
                                            #        # # #                                           
   #                                   #   #     #         #                           #          ## 
                                      #             #                                                
                                      #       ### # ##    # #       ##                              #
 #                                                #                #                                 
 #                                           #      ### # ##        #                               #
          #                        #  #               #    #          #      #                       
    #                        #        #               #           #                            #     
                               #                      #   #               #          #               
    #                                     # #     #    #              #                              
                #           #         #            #       #                                         
                                                     #    #         #   #                            
                           #                     ##   #    #                                         
                                      #            # #  #                                            
                                                              #                                      
   #                                  #          ##       #                                          
#                                                 #  #     ##              #                         
                                                   #        ##                                       
#                                     #          # #       #        #                                
        #    #                        #       ##  # #        #                                       
                                                                                     #               
                                     #              # #  #                  #                        
                    #                   #                                                           #
                                                   #    #                 #                          
                                      #        #   ###      #                                        
                                    # #   #      ## #         #                          #           
                                                 # #        #                                        
                   #                  #          ##                                                  
                                                   #  #      # #    #        #                       
                                                   #   # #                                           
                                                   #   ###   #      #                                
     #                                         #   # #      #                                        
                                           #           # #                                           
                                      #       #     # # #             #                              
                                      #           ## # ##                                            
                     #                                 #                                             
                               #                                    #    #                           
          #                  #                        #       #                                      
                                      #             ##              #                                
                                             #        #  #                                   #  #    
                                    #          #     ##                                              
                                                        #    #                                       
                                                          #         # #                              
                                                ##    #                 #                            
                                                     #  #       #                                    
             #                #                     #    # #                              #          
     #                                   #                #                                          
                        # #                #          #                                              
                         #          #         #       #                                              
  #                                   #           #                                                  
                                                  #       ##                            #            
                                      #        #  # #        #                           #   #       
           #  #  #                    #            #                #                                
             #                        #      #  #         #         #                                
                                                      #             #                                
                                                   #     #          #                                
                                                                    #             #                  
#                                     #     #    # #  ##                           #                 
                                      #  #        #      #    #                                      
     #                                              #  ##                                            
                       #                               ##           #              #       #         
                                                       #                          #                  
                                                                                           #         
                                               ##    #    #                                          
                                              #            #     #  #          #                     
                     #                            #      #          #                                
                         #                            #             #                                
       #                                          # #  #                                             
                                                         #                                           
                                             #  #    #                        #                      
                                                                                                     
                                          #         #  #                                             
                                                #           #                                        
                                   #                # #  #              #                            
                                           #        #  #                                             
                              #                                                    #                 
  #                                    #             #                                               
       #                                                                     #                    #  
                                      #               #    ##       #                                
            #                  #   #  #      #  #   ## #            #   #               #            
                                              ####   #            # # #                              
                                      #              # ##           #                                
                                               #    #  #  #                                          
                                                     ##            #      #           #              
                                                #   #   #                                            
                                                   #    #   #  #    #                                
                                                ##    #                     #                        
                   #                                     #     #                                     
                                      #               # #        #                                   
                                                  #        ###      # #                              
                                            #         # #       #   #                                
                                      # #    #  ##     #    #                                        
#                                                   #            #                                   
                                      #       # #         #         #               #                
                                                ##   #    #                                          
                            #                   #  #  #   #                   #   #                  
                                              #         ##                                           
                      #                          #   #                  #                       #    
 #               #              #     #        #     # ##                                            