
     #                                              #  ##   #                                        
     #                             #  #            ##      #                                         
                                                   #     #   #      #                                
                            #         #        #        #               #                            
                                                ##  #  #                                             
                                               #                                             #       
                                #     #     #       ###     #   #         #                #         
                                      #             #               #                               #
                                      #            #  # #   #       #    #                           
                                                      # #  #                       #                 
                     #         #                 #      #                                  #      #  
                                                        #  #        #                                
                                      #   #  #  # ### #   #         #                                
                                                 #       #                                           
#                                                   #             # #   #   #                        
                   #                      #        #   #                                             
                                                   # #                                               
                                                     ##                                      #       
   #                                  #      #   ##            #    #                                
          #                            #          #    #              #                              
                                      #     #  #         #  #                #                       
                                    #    #              #                                            
                      #                          ## #      #                                         
                   #           #      #          ##                 #                                
             #      #                                                 #                              
                                               #  #       #      #  #              #                 
                                                    #  #  #                                          
                             #                #   #                                                  
  #                        #                     #    #    #                                         
                                                #                                                    
             #   #                 #            #  # #  #         #                                  
                                      #            ##                                                
                                                    ###                                            # 
 #                                           #       #              #                                
                                                   ##  #     #                                       
                                                 #  #         #                                      
                                               # #  #                                                
                     #                             # ### # #                                         
        #                                           ##    #                                          
                                             #      #   #                     #                     #
                         #                        #                           #                      
                                                                      # #                            
    #                                              # # # # #     #                                   
                          #                       ##                                  #              
  #                                      #  #      # #                  #           #                
                                      #        #       #   #                                         
          #                                           #   #    #                                #    
                                              #                                   #                  
                                                 #                                                   
                                       #         #      #   # #                                      
                              #              ##     #       #                                        
                                                      #                                              
   #                        #                                    #                   #               
                                               ###       #          # # #                            
                                                          #         #                                
             #                                #   #  ##                                              
                         #   #        #          #                  ##                               
                                           #      ##   #            #                #               
                                           #         # #            # #                              
                                      #                       #              #                       
           #                          #          ###     #  ##      #                  #             
                                               #   #                      #                          
                #                     #        #     #                                               
#                                                                                                    
                                     #          #    ##            #                                 
                                                # #                 #                     #          
              #                       #                ##                                           #
                                             #  #        #                                           
                                                #                         #                          
                                      #                                                              
                                      #              ######           #                              
                       #              #     #      #    #                                            
                                                  ## # #                                             
                              #                # #     #            #                                
                                                  # #  #    #       #       #          #             
                                                                    #                                
                                               #      #  #                        #            #     
                                                #   #       #                                        
                                                #   # #             #                                
                                      #            #                                                 
                                    #                    ###                                         
                                        #           #     ##   #                                     
       #    #           #                  #    ## # #    #                    #                     
                                           #                #      ##                                
                                              #     #               #                                
       #         #                    #       ###     #   #  #                           #           
                                        #         # ###                                              
                                      #               #                           #     #            
                                                         #                                           
                                                 #      #      #                                     
 #                                    #            # #   #      #   #                    #           
 #                 #                  #         #        #                                           
#                                                    #  #  #  #                         #            
                                      #             # #     ##      #                                
                                                        #           #                           #    
                                      #       #   #  #    #         #        #                       
                                   #       #       #   # #                         #                 
     #                                #         #      #                                             
#                                                     #                                              
                                      #           #   #   #               #                          
                               #                  #      #                                        #  
                                      #       #  #  #  #  #                                          
    #                               #     #             # #                #                         