
#                                     #          #   #         #    #                                
                                          #       # #       #                     #                  
                                                           #    #   #                    #           
                                                 ###        #                       #                
                                                  #  #          #     #                              
                                   ##   #          #    # #                                          
                                             ##   #                     #                            
                                      #          #  # #  #   #   #        #                          
                                                 #  #  ###                                   #       
                                                    #   #                                            
                                                      #   #                                          
          #          #                #        #   #                    #                            
                              #                    #          #     #                                
                                      #    #    ## ##    # ##                                        
                               #      #       #   ## #              #                      #         
                                                      #####                                          
                                          #           ##            #                                
                                           #      ##  #                                              
                                                           #  #  #  #                                
                 #                           # #      #            #                            #    
                                                             #                                       
                                                ##  #  #            #   #                           #
                       #     #                        # #           ##                               
     #                                      ##  #     #          #                                   
                                                                    #                                
                                      #                   #         #                                
                                      #              #                  ##                           
   #                                  #          # #    #                                            
                         #            #   #         #    #                                           
                                                #                                       #            
   #                                  #        #    #  #                                             
                                               #  ##                # # #                            
 #         #       #                  #                    #                                         
                                      #             #        #        #                        #     
                                       #        ##   # #            #                                
                #                     #             #               #                                
        #                             #              #   #                                           
             #                                  #                   #                                
                    #                 #           #  # #     #                                       
                                                     #  #           #                                
                                                #  #                                                 
     #                                                                        #                      
                                                 # #  #               #               #              
                              #               #       #        #           #                         
                         #            #                  #    #     #                                
    #                                            #                  #                                
                                        #       #         #  #      #                        #  #    
                           #                     #    #                                              
                                      #           #   # #                 #                          
#            #                 #                #           #                                      # 
                             #     #   #                                                             
                     #                #                        #    #                #   #           
                                                                                                     
                                                # # # #  #          #        #                    #  
                                                                                                     
                                                    ##                                               
                                               #   # # #                                  #          
                            #                      #  # #  #                       #                 
                                      #      ##     ## #  #         #                                
          #                           #           #  #                                               
             #        #         #           #             # #             #                          
                                                  #      #                                           
                                               #          #                          #  #            
                                                    #    #                                           
 #                                 #  #                  #  #                                        
                                                     #    #                                  #       
                                              # #          # #                                       
                                              #      ##                                              
                                                                                                     
                                              #      #   #                                           
#                                              #       #  # #                                        
 #                      #                  #     #  #    # #                  #                      
                                                   ##                                                
                                               #     ##            #                                 
                                      #              #     ##       #                                
     # #                                     #                                                       
                                      #         #      #    #       #        #                       
                                    #      ##  #                                                     
                                               #      ###    #      #                                
                                                    ## ##                                  #         
                                      #          ###    #                                            
                                      #           #   #       #     #                                
                   #                               #    #  #                                         
    #              #                                 # #   #          #     #                        
#                              #                      #                                              
                                               #    #     #                        #   #             
                                      #  #         # ##                                              
                                                       #                       #       #             
                 #                              ##   #                                               
            #                                    #     #   ##                                        
  #    #                            #                                                                
                                                    # #                     #                        
                                                  # #     #                                          
                                                  # ##                                               
                                      #           #                 #              #                 
                            #         #    ##         #  #            #                           # #
                                      #         #   #   # #       # #                                
                                                 #    # # #                                          
                                      #      #          ##                #                          
              #           #                      #                #                                  
  #                                  #            #    ###                   #                       
                                      #       #       #                                              
                                         #         ###                            #                  