
                                                #       #           #                     #          
                                      #       #  #          ##                                       
                                    #           # # ##   ###   #      #                              
                                      #             #       ##  #                                    
                                         #     #   #     #          #                                
                           #                  # #                   ##                               
                                                          ##     #                                 # 
                                                   #   #   #   #                                     
                                    # #              #   #          #     #                          
                                      #      #        #             #                                
 ##  #       #                                # ###  #                    #                          
                                   #            #                                                    
                                                     # ###          #             #      #          #
                                                         ##                                          
                        ##                 #   #    #### #                                           
                                     #                #     #                                #       
                               #      #    #         #      #                                        
                                               #       #            #                                
           #                          #             #                        #             #         
                                                      #      #                                       
       #                                       #              #                    #                 
                                                #  #                                                 
    #                                                # #    #                                   #    
                                      #         #       # #         #                                
                          #                        #           #    #                                
                                                 ####  #                                             
                                        #              #                                             
                                             #          #                                            
 #           #                                  ##    #                                             #
                                                #            #        #                              
                                                   # #                                               
                                                     ###            # #                              
                                                             #      #                                
  #                           #       #            ###                       #                       
     #                                              ##   #        #                 #                
        #                                       #           #            #                           
   #                                      #  #    #  #    #                 #                        
                                              #         #  #        #                                
                 #                    #          # #  #               #        #                     
                                               #  # # # #                              #             
                                                      #                                              
       #    #                                        ##                                              
#                                     #           #   #   #                                          
                                               #     #              #                                
                                   #  #          #      #                                            
          #         #                          #         #    #                                      
                         #                     #    #       #                                        
                             #                                                                       
                                                   ## #            #                 #               
                       #                        #     #                                ##            
                                              #    #    #  #                                         
                                                                    #        #                       
                                                            ##                                       
                                                 # #   #   ##                                        
 #                                    #         ##     #                                             
                                      #                   #                                  #       
                                                ##                  #                                
#                                                #     #            #                           #    
                     #                              ##      #                                       #
                                      #       #   #  ##                 #                            
                   #               #               #             #  #                                
                                                 ##     #     # #                 #                  
                               #           #  #     #  ##  #                               #         
                     #                                              #                          #     
     #        #                                          #                #                          
                 #          #                   #   #                      #                         
   #                                  #        # #  # #    # #                                       
                                                  #        #                         #               
                                      #     #    ##    ## ##       #                                 
                                                   #   #              #   #                          
                                      # #          ## # ##              #                            
                             #                        #                                              
                                                                                                     
                #                     #          # #    ##                                           
                                      #        #  #    #  #                                          
             #                                          #                                            
                               #          # #    #  ## #            #   #                            
#                                     #            #                #              #                 
                                             #   #        #                 #     #                  
          #        #  #               #      #     #  ##              #                              
                                      #     ##    ##  ##            #                                
                                                   ##                                             #  
                                      #           # # ##          # #                                
                                                     #  #                                #           
                            #                   ##   #   #                                           
                                      #           #     #  #        #                                
                                                    # #     #                                     #  
                                #     #    #     #    #             #         #                      
                                            #                                                        
                                                    #                              #                 
                                                 #        #                                          
                              #          #        #                 #                                
                   #                                 #  #     #                                      
                                       #            # #   #             #     #       #              
                                      #    #                   #    #                                
                                    #               ##   #                                   #       
                                                  #                                                  
                                      #   #       #  ##   #                                          
#   #                                 #             #     #                                          
                                                     #              #                                
                                      #           #                                                  
                                               #  #    ##  #     #  #                   #            
                                       #       #      #  ##                                          