
                                     ##        #          #         #     #                          
                                                  #    #              #                              
                                                   #    #  #         #                               
  #                                   #         #  #                  #     #                       #
                                                 #  #                                                
                                    #                #                        #                     #
#                                  #                #    #                   #                       
                #                     #         #  # ## # #                                          
  #                                         #         #       #                                      
                                      #      #            #         #                                
                        ##  #              #   #  #                                                  
             #   #                    #                #  #                       #                  
                                                   #   #    #    #                     #             
                             #  #   #           #    #              #   #                            
                               #      #          #                  #                                
                                                 #  #   ##                                           
                                      #         #          ##    #                                   
                                      #   #  #          #         #       #             #            
                                                      #                                              
                                                      ##            #                                
                                      #        #                                                     
                                                  #  #          #                                    
                    #                               ##   #                               #           
                                                                                                     
                                                   #     #            #                              
                                                  #  # # #          #                                
                                          # #   #      #                                             
                                      #     ## #   #   #   #        #                                
          #                           #            ###     # #                     #                 
                                                     #          #                                    
                                                 # # ##     #       #        #                       
   #                                              ### #                                              
                                      #                                 #                            
                                      # #          #    #           #                        #       
                               #                 #         #                                         
                     #    #                           #   #         #                                
                                                       # #                                           
                                                       #                                             
                                         # #    #   ###   #  #                           #     #     
                                                 ##  #     #                                         
                           #                           #      #                                      
                                                    # #   #        #                                 
     #             #                          #  ###   #  #                                     # #  
                                                   #      #         #                  #             
                   #                           # #    ##  #         #                                
                                                  # #               #                                
                      #               #         # # #                                                
                                              ##        ## # #                                       
                   #                             #                                                   
                                            #         #                   #                #         
                                      #       #       #        #    #                                
          #                   #                 #     # #    #                                       
                                      #                                                              
     #  #                             #                   #                                          
                     #                                              #                                
                                      #        ##     ###   #      #                                 
     #                                #           # #               #                                
                                    #                #         # #                 #                 
 #                                                      #             #     #                #       
                                               # ## #   #               #                  #       # 
                         #                      # ###  ##  #   #      #                              
#                #                     #     #      # #             #                                
                                                   #        #                                        
                                           #      #     #                                            
           #                          #                   #                                          
#                                                      #                                             
                                                                                                     
                              #                #                                                     
                                                   # #                    #                          
                                      #             ##        #                                      
 #                                    #             #       #                                #       
    #                                                    #  #       #                               #
                                                    ##              #                                
                                      #       # #  #         #                                       
                                                  ##     #                         #                 
                                                     #  #                                            
              #                                       #  # #        #                                
                                        #         #  #       #      #                                
 #                     #                   #         # #    #       #                                
                                                                  #      #                           
                                                #  #  #   # #                        #               
            #                                   #                   #      #              #          
                                                 #       #          #                                
       #                       #         #       #                                                   
                                           # #  #  # ## ##                    #                      
   #                                                  #  # #                                         
                                   #         #       ##             #        #                       
             #                                          #      #                  #                  
                                                                                                     
                                      #        # #   #              #                                
    #                       #                    #  #   #           #   #                            
                                                    # #                                              
                                                    #  #                                          #  
                                      ##      #  #                                                   
             #                                    #   #                             #           #    
                                   #                                                                 
                                               #     #  # ###                  #                     
                                              #   # #        #                                       
                                      #   #      #                  #             #                  
       #                                       #    #  ##                                            
#                                     #              # # #  # #                                      
                             #        #               ## ##         # #                 #            
                                               #    ##                  #            ##              