
                                    #                 # #   #       #                                
  #                                   #          #   #    # #                 #                      
                                             ## #     #             #                          #     
                               #             #      #               #        #             #         
          #                                                         #                     #          
                                               #   #     #                                           
                     #                #   # #     # #            #                                   
 #                                                            #       #                              
                           #          #       #  #    #                 #                            
                                      #          ##      #        #                             #    
                                       #             ##             #                                
                                      #                  #          #                                
                                      #                    #                       #                 
        #                                  #                 #                                       
                              #       #                                      #                       
            # #          #                                                                           
                             #     #                                #     #                          
                                                  #  #    #       # #                                
                                      #          #  #  #   #   #    #                                
    #      #                          #       #   #   ## #          #                                
                                                #        #  #   #   #                               #
                                      #           #   #      #      #                                
                          #                #            #                                            
 #                          #                     #  ##                                              
                                                #                   #                                
                       #                        # #  # ##     #                                      
#                                                #                                       #           
                                                #      #  #              #    #                      
    ##                                           #     #                                             
                                                        # #                                          
                                                                                                     
                                               # #   #  #                 #                          
                                                   #   #  ##        #       #      #    #            
                                                   # # ##  #        #                                
                                                ##  #    #                 #                 #       
                                                #   #    #                                           
             #                                  #   #  #              # #                            
                                            #       #    #  #                          #             
                                      #     #     #  #              #                                
                               #      #             #                                                
                                   #                 #     ##                                        
                                                  #         #                                        
                                      #                                           #                  
                                      #     #      #                 #  #                            
                                               #  #   # ##            #                              
                                      #              ### #                                           
       #                                  #      ##  ###   ##                                        
                 #                            # #         ##                                         
                                                          ##                                         
     #                                              ##              # #                              
                                                              #  #  #   #                            
                                              ###   #      ##    #  #                                
                                       #                                                             
                                                   #    #                                            
                                      #  #         #  #                                      #       
                                         #     #          #                                          
                                               #     #  #                                            
                                          ##      ####    #    #                       #             
                                        #      #    ##         #    #                                
                                                      ###                                    #       
 #                          #  #               # #  # #      #                                       
                                                #    #             #                                 
                                                   #  ##    #       #                                
                                #                #    #  # #                                         
                                      #           # #   #    #                                       
   #                                              #   ##                          #                  
                                      #          ##                 #                    #           
                                      #       #    #         #                                       
                                      #          #                 ##                               #
                                                                                                #    
     #                                              ###             #                                
                 #                    #                                                              
          #                           #              #                       #     #                 
                   #                  #      #  ###                                                  
                     #             ##          # # #                                 #               
#                                               # #   #                                              
                                                            #       #                                
                                             #    ##   #  #         #                   #            
                                                        # #           #                              
             #                        #            #                                              # #
                                                        #     #                                      
                                                    # #      #        #                              
                                           #    ##   # ##           #     #           #              
                              #                     ### #  #                                         
                             #                     ## #         #                                    
                #     #               #        #                    #                #               
                                      #                 #                                            
                                               ##  ##  #                                             
                                              #    ##  # #                                           
                                                     # #                                             
                         #                     #    # #                                            # 
                   #                                                                                 
                                      #             #                   #         #                  
                                                  ##                           #                     
#                  #                  #                  #                                        #  
                                                   #                #                                
#      #     #      #                 #                ##                                            
                                      #        ##  ##                                                
                                             #            #                         #                
                        #                  #     # #  # #                                            
   #                                  #          #   # ## #               #                #         
                                        #     #          ##         #       #                        
                                    ##           #          #  #    #                                